S ./assets/surfaces/wood.xpm
                R 1280 720
     NO       ./assets/surfaces/115.xpm
           SO ./assets/surfaces/115.xpm
WE ./assets/surfaces/115.xpm
EA    ./assets/surfaces/115.xpm


F    243,233,177
   C 124,199,160

       
    
     
    1111111      1111111    111111111111111111 
   1000S001     10000001    100000000000000001 
  100000001    100000001    100000000000000001 
  111000001    111000001    100000111111111111 
     100001       100001    1000001            
     100001       100001    1000001            
     100001       100001    1000001111111111   
     102001       100001    10000000000000001  
     100001       100001    111111111111000001 
     100001       100001                1000001
     100001       100001                1000001
     100001       100001   11111111     1000001
  111000000111 11100000011100000000111110000001
  10000000000010000000000000111000000000000011 
  10000000000000000000000011   1100000000011   
  1111111111111111111111111      1111111111
