#_________________________/\\\____________/\\\\\\\\\\___/\\\\\\\\\\\\_________
#_________________________\/\\\__________/\\\///////\\\_\/\\\////////\\\______
#__________________________\/\\\_________\///______/\\\__\/\\\______\//\\\____
#___/\\\\\\\\__/\\\____/\\\_\/\\\________________/\\\//___\/\\\_______\/\\\___
#__/\\\//////__\/\\\___\/\\\_\/\\\\\\\\\_________\////\\\__\/\\\_______\/\\\__
#__/\\\_________\/\\\___\/\\\_\/\\\////\\\___________\//\\\_\/\\\_______\/\\\_
#__\//\\\________\/\\\___\/\\\_\/\\\__\/\\\__/\\\______/\\\__\/\\\_______/\\\_
#____\///\\\\\\\\_\//\\\\\\\\\__\/\\\\\\\\\__\///\\\\\\\\\/___\/\\\\\\\\\\\\/_
#_______\////////___\/////////___\/////////_____\/////////_____\////////////__

#SPRITE TEX & INFO & ANIMATION
#	PATH
SP_CONFIG	./maps/sprite_configs/final.spconfig

#SURFACE TEX & INFO & ANIMATION
#	PATH
SF_CONFIG	./maps/surface_configs/hexen.sfconfig

#RESOLUTION
#	X     Y
R	960		480

#MINIMAP INFO
#		  RATIO_X	RATIO_Y	TILESIZE	WALL_COLOR		FLOOR_COLOR		PLAYER_COLOR
MINI	5		    5		    12			  184,240,195		31,50,58		  255,255,255


# For Sprites (SP), Teleportations (TP) and Monsters (MOB)
# The TYPE argument refers to a predefined sprite or monster type index
# As defined in the linked sprite config file (.spconfig)

#SPRITE POS
SP

{
#	TYPE	POSX	POSY
	1		  10.5	7.5
	1		  18.5	7	
	2		  1		  18	
	2		  1		  7	
	1		  7.8		3.2	
	1		  5.5		5.5
	3		  6.5		6.5
	4		  6.5		7.5
	2		  7.5		2.5
	10		3.5		14.5
}

# TELEPORT POS
TP

{
#	TYPE	POSX	POSY	TPOSX	TPOSY
	6		  7.5		14.5	3.5		3.5
	6		  3.5		3.5		7.5		14.5
}

#MOB POS
MOB

{
#	TYPE	POSX	POSY
	1		13.5	4.5
	1		13.5	5.5
	1		13.5	6.5
	1		11.5	4.5
	1		11.5	5.5
	1		11.5	6.5
	1		15.5	4.5
	1		15.5	5.5
	1		15.5	6.5
	2		18.5	11.5
}


# NEXT LEVEL
#     MAPFILE
NEXT	./maps/testload.cub

#PLAYER & WALL MAP
#	LINENBR
MAP 33

{
1111111155555555544444444                    1111111 1111111                  
100000S000000000000000004                    1000001 1000001                 
1000000000000000000000004                    1000001 1000001
1100000050000500005000044                    1000001 1000001                 
  100000000000000000004     555555555555     100001  100001    11111111111  
  100000500000000050004   5500000000000055   100001  100001  110000000000011 
  100000000000000000004  50000005555500000111100001  100001 10000000000000001
  100000500005000050004 50000005     50000000000001  100001 10000011111000001
  100000000000000000004 500000005555500000011100001  100001 100001     100001
  100000003333300000004 5000000000000000005  100001  100001 100001     100001
  10000001     40000004 500000055555555555   100001  100001 100001     100001
  10000001     400000044400000005            100001  100001 100001     100001
  10000001     400000000000000005           100000011000000110000011111000001
  10000001     40000000440000000055555555   100000000000000000000000000000001
  10000001     400000004455500000000000005  100000011000000111100000000000111 
  11101111     44444444    555555555555555  1111111111111111   11111111111   
    202
    2022222      1111111    111111111111111111 
   20000002     10000001    100000000000000001 
  200000002    100000001    100000000000000001 
  222000002    111000001    100000111111111111 
     200002       100001    1000001            
     200002       100001    1000001            
     200002       100001    1000001111111111   
     200002       100001    10000000000000001  
     200002       100001    111111111111000001 
     200002       100001                1000001
     200002       100001                1000001
     200002       100001   11111111     1000001
  222000000222 11100000011100000000111110000001
  20000000000020000000000000111000000000000011 
  20000000000000000000000021   1100000000011   
  2222222222222222222222222      111111111
}
#FLOOR MAP
MAPF

{
000000000       000000000                    0000000 0000000                  
0000 0000       000000000                    0000000 0000000                 
222222222       222222222                    2222222 2222222
011111110       000000000                    0000000 0000000                 
  0000000       0000000     000000000000     000000  000000    00000000000  
  0022200       0000000   0000000000000000   000000  000000  000000000000000 
  111111111111111111111  11111111111111111111111111  111111 11111111111111111
  111111144444444411111 11111111     11111111111111  111111 11111111111111111
  111111144444444411111 111111111111111111111111111  111111 111111     111111
  222222222222222222222 2222222222222222222  222222  222222 222222     222222
  000000044444400000000 000000000000000000   000000  000000 000000     000000
  00440000     000000000000000000            000000  000000 000000     000000
  00440000     000000000000000000           000000000000000000000000000000000
  00440000     00000000000000000000000000   000000000000000000000000000000000
  00440000     000000000000000000000000000  000000000000000000000000000000000 
  44444444     44444444    444444444444444  4444444444444444   44444444444   
    000
    0000000      0000000    000000000000000000 
   00000000     00000000    000000000000000000 
  111111111    111111111    111111111111111111 
  000000000    000000000    000000000000000000 
     000000       000000    0000000            
     000000       000000    0000000            
     000000       000000    0000000000000000   
     000000       000000    00000000000000000  
     000000       000000    000000000000000000 
     000000       000000                0000000
     000000       000000                0000000
     000000       000000   00000000     0000000
  000000000000 00000000000000000000000000000000
  00000000000000000000000000000000000000000000 
  00000000000000000000000000   0000000000000   
  0000000000000000000000000      000000000
}

#CEILING MAP
MAPC

{
111111111       111111111                    1111111 1111111                  
111111111       111111111                    1111111 1111111                 
111pp1111       111111111                    1111111 1111111
111111111       111111111                    1111111 1111111                 
  0000000       0000000     000000000000     000000  000000    00000000000  
  0000000       0000000   0000000000000000   000000  000000  000000000000000 
  000000000000000000000  00000000000000000000000000  000000 00000000000000000
  1111111        111111 11111111     11111111111111  111111 11111111111111111
  2222222        222222 222222222222222222222222222  222222 222222     222222
  111111111111111111111 1111111111111111111  111111  111111 111111     111111
  1111%^11     11111111 111111111111111111   111111  111111 111111     111111
  00000000     000000000000000000            000000  000000 000000     000000
  00000000     000000000000000000           000000000000000000000000000000000
  222#2222     22222222222222222222222222   222222222222222222222222222222222
  11111111     111111111111111111111111111  111111111111111111111111111111111 
  33333333     33333333    333333333333333  3333333333333333   33333333333   
    000
    1111111      1111111    111111111111111111 
   00000000     00000000    000000000000000000 
  000000000    000000000    000000000000000000 
  333333333    333333333    333333333333333333 
     000000       000000    0000000            
     444444       444444    4444444            
     000000       000000    0000000000000000   
     444444       444444    44444444444444444  
     444444       444444    444444444444444444 
     000000       000000                0000000
     222222       222222                2222222
     222222       222222   22222222     2222222
  000000000000 00000000000000000000000000000000
  44444444444444444444444444444444444444444444 
  44444444444444444444444444   4444444444444   
  0000000000000000000000000      000000000
}
