#_________________________/\\\____________/\\\\\\\\\\___/\\\\\\\\\\\\_________
#_________________________\/\\\__________/\\\///////\\\_\/\\\////////\\\______
#__________________________\/\\\_________\///______/\\\__\/\\\______\//\\\____
#___/\\\\\\\\__/\\\____/\\\_\/\\\________________/\\\//___\/\\\_______\/\\\___
#__/\\\//////__\/\\\___\/\\\_\/\\\\\\\\\_________\////\\\__\/\\\_______\/\\\__
#__/\\\_________\/\\\___\/\\\_\/\\\////\\\___________\//\\\_\/\\\_______\/\\\_
#__\//\\\________\/\\\___\/\\\_\/\\\__\/\\\__/\\\______/\\\__\/\\\_______/\\\_
#____\///\\\\\\\\_\//\\\\\\\\\__\/\\\\\\\\\__\///\\\\\\\\\/___\/\\\\\\\\\\\\/_
#_______\////////___\/////////___\/////////_____\/////////_____\////////////__

#SPRITE TEX & INFO & ANIMATION
#	PATH
SP_CONFIG	./hexen.spconfig

#SURFACE TEX & INFO & ANIMATION
#	PATH
SF_CONFIG	./hexen.sfconfig

#RESOLUTION
#	X		Y
R	960		480

#MINIMAP INFO
#		RATIO_X	RATIO_Y	TILESIZE	WALL_COLOR		FLOOR_COLOR		PLAYER_COLOR
MINI	5		5		12			184,240,195		31,50,58		255,255,255

#SPRITE POS
SP

{
#	TYPE	POSX	POSY
	1		2.5		2.5
	27		3.5		2.5
	3		4.5		2.5
	4		5.5		2.5
	5		6.5		2.5
	6		7.5		2.5
	7		8.5		2.5
	8		9.5		2.5
	9		10.5	2.5
	10		11.5	2.5
	11		12.5	2.5
	12		13.5	2.5
	13		14.5	2.5
	14		15.5	2.5
	15		16.5	2.5
	16		17.5	2.5
	17		18.5	2.5
	18		19.5	2.5
	19		20.5	2.5
	20		21.5	2.5
	21		22.5	2.5
	22		23.5	2.5
	23		24.5	2.5
	24		25.5	2.5
	25		26.5	2.5
	26		27.5	2.5
}

TP

{
#	TYPE	POSX	POSY	TPOSX	TPOSY
}

MOB
{
#	TYPE	POSX	POSY
	1		10.5	5.5
	2		11.5	5.5
}

NEXT	./maps/final.cub

#PLAYER & WALL MAP
#	LINENBR
MAP 12

{
111111111111111111111111111111111111111111111111111111111111111111111
100000000000000000000000000000000000000000000000000000000000000000001
100000000000000000000000000000000000000000000000000000000000000000001
100000000000000000000000000000000000000000000000000000000000000000001
100000000000000000000000000000000000000000000000000000000000000000001
100000000000000000000000000000000000000000000000000000000000000000001
10000000000000000000000000000000S000000000000000000000000000000000001
100000000000000000000000000000000000000000000000000000000000000000001
100000000000000000000000000000000000000000000000000000000000000000001
100000000000000000000000000000000000000000000000000000000000000000001
100000000000000000000000000000000000000000000000000000000000000000001
111111111111111111111111111111111111111111111111111111111111111111111
}
#FLOOR MAP
MAPF

{



 0123456789abcdefghijklmnopqrstuvwxyzABCDEFGHIJKLMNOPQRSTUVWXYZ








}

#CEILING MAP
MAPC

{


 0123456789abcdefghijklmnopqrstuvwxyzABCDEFGHIJKLMNOPQRSTUVWXYZ









}
