#_________________________/\\\____________/\\\\\\\\\\___/\\\\\\\\\\\\_________
#_________________________\/\\\__________/\\\///////\\\_\/\\\////////\\\______
#__________________________\/\\\_________\///______/\\\__\/\\\______\//\\\____
#___/\\\\\\\\__/\\\____/\\\_\/\\\________________/\\\//___\/\\\_______\/\\\___
#__/\\\//////__\/\\\___\/\\\_\/\\\\\\\\\_________\////\\\__\/\\\_______\/\\\__
#__/\\\_________\/\\\___\/\\\_\/\\\////\\\___________\//\\\_\/\\\_______\/\\\_
#__\//\\\________\/\\\___\/\\\_\/\\\__\/\\\__/\\\______/\\\__\/\\\_______/\\\_
#____\///\\\\\\\\_\//\\\\\\\\\__\/\\\\\\\\\__\///\\\\\\\\\/___\/\\\\\\\\\\\\/_
#_______\////////___\/////////___\/////////_____\/////////_____\////////////__

#SPRITE TEX & INFO & ANIMATION
#	PATH
SP_CONFIG	./maps/sprite_configs/final.spconfig

#SURFACE TEX & INFO & ANIMATION
#	PATH
SF_CONFIG	./maps/surface_configs/final.sfconfig

#RESOLUTION
#	X		Y
R	960		480

#MINIMAP INFO
#		RATIO_X	RATIO_Y	TILESIZE	WALL_COLOR		FLOOR_COLOR		PLAYER_COLOR
MINI	5		5		12			184,240,195		31,50,58		255,255,255

#SPRITE POS
SP

{
#	TYPE	POSX	POSY
	1		10.5	7.5
	1		18.5	7	
	2		1		18	
	2		1		7	
	1		5.5		5.5
	3		6.5		6.5
	4		6.5		7.5
	2		7.5		2.5
	10		8.5		14.5
}

TP

{
#	TYPE	POSX	POSY	TPOSX	TPOSY
	6		7.5		14.5	7.5		1.5
	6		7.5		1.5		7.5		14.5
}

MOB
{
#	TYPE	POSX	POSY
#	1		13.5	4.5
#	1		13.5	5.5
#	1		13.5	6.5
#	1		11.5	4.5
#	1		11.5	5.5
#	1		11.5	6.5
#	1		15.5	4.5
#	1		15.5	5.5
#	1		15.5	6.5
	2		8.5		14.5
}

NEXT	./maps/final.cub


#PLAYER & WALL MAP
#	LINENBR
MAP 16

{
    2522222      1111111    111111111111111111 
   20000002     10000001    100000000000000001 
  200000002    100000001    100000000000000001 
  22200N002    111000001    100000111111111111 
     200002       100001    1000001            
     200002       100001    1000001            
     200002       100001    1000001111111111   
     200002       100001    10000000000000001  
     200002       100001    111111111111000001 
     200002       100001                1000001
     200002       100001                1000001
     200002       100001   11111111     1000001
  222000000222 11100000011100000000111110000001
  20000000000020000000000000111000000000000011 
  20000000000000000000000021   1100000000011   
  2222222222222222222222222      111111111
}
#FLOOR MAP
MAPF

{
    0000000      0000000    000000000000000000 
   00000000     00000000    000000000000000000 
  111111111    111111111    111111111111111111 
  000000000    000000000    000000000000000000 
     000000       000000    0000000            
     000000       000000    0000000            
     000000       000000    0000000000000000   
     000000       000000    00000000000000000  
     000000       000000    000000000000000000 
     000000       000000                0000000
     000000       000000                0000000
     000000       000000   00000000     0000000
  000000000000 00000000000000000000000000000000
  00000000000000000000000000000000000000000000 
  00000000000000000000000000   0000000000000   
  0000000000000000000000000      000000000
}

#CEILING MAP
MAPC

{
    1111111      1111111    111111111111111111 
   00000000     00000000    000000000000000000 
  000000000    000000000    000000000000000000 
  333333333    333333333    333333333333333333 
     000000       000000    0000000            
     444444       444444    4444444            
     000000       000000    0000000000000000   
     444444       444444    44444444444444444  
     444444       444444    444444444444444444 
     000000       000000                0000000
     222222       222222                2222222
     222222       222222   22222222     2222222
  000000000000 00000000000000000000000000000000
  44444444444444444444444444444444444444444444 
  44444444444444444444444444   4444444444444   
  0000000000000000000000000      000000000
}
