S ./assets/surfaces/wood.xpm
R 214748 10000
     NO       ./assets/surfaces/brick.xpm
           SO ./assets/surfaces/metal.xpm
TE ./assets/surfaces/wood.xpm
EA    ./assets/surfaces/stone.xpm

F    243,200,177
   C 124,199,160


11111111111111111111
1001                
111111111        111111111                    1111111 1111111                  
1000002021      100000001                    1000001 1000001                 
 100000221     100000001                    1000001 1000001
 110000001     100000011                    1000001 1000001                 
  10000001     1000001      1111111111111    100001  100001    111111111111  
   10000001     1000001    1100000000000011   100001  100001  110000000000011 
    1000000111110000001   10000001111100000111100001  100001 10000000000000001
    10N0000002000000001  10000001     10000000000001  100001 10000011111000001
    1000000000000000001  100000001111100000011100001  100001 100001     100001
    1000000111110000001  1000000000000000001  100001  100001 100001     100001
    1000001     1000001  100000011111111111   100001  100001 100001     100001
    1000001     1000001111100000001           100001  100001 100001     100001
  110000001     1000002222200000001          100000011000000110000011111000001
  100000001     100000001110000000011111111  100000000000000000000000000000001
  100000001     100000001  1100000000000001  100000011000000111100000000000111 
  111011111     111111111    11111111111111  1111111111111111   11111111111   
    101
    1011111      1111111    111111111111111111 
   10000001     10000001    100000000000000001 
  100000001    100000001    100000000000000001 
  111000001    111000001    100000111111111111 
     100001       100001    1000001            
     100001       100001    1000001            
     100001       100001    1000001111111111   
     100001       100001    10000000000000001  
     100001       100001    111111111111000001 
     100001       100001                1000001
     100001       100001                1000001
     100001       100001   11111111     1000001
  111000000111 11100000011100000000111110000001
  10000000000010000000000000111000000000000011 
  10000000000000000000000011   1100000000011   
  1111111111111111111111111      111111111


