R 1000   800







WE ./texture/MCHIBAE.xpm
   EA ./texture/NEUTRAL_MILK_HOTEL.xpm
SO             ./texture/THE_PROTOMEN.xpm

         C 225,30,0
F          220,100,0
S ./texture/mchibabe.xpm   

NO ./texture/MIRACLE_MUSICAL.xpm
 
11111 1111
11 11 1111
1111111111
1100000001
1000200201
1000000001
1000200001
1000000001
1010000001
1000000001
1000000N01
1111111111


1111111111
1000100001
1010001101
1011101101
1001100001
1111111111
